######################
#           ###### ###
####    E   ###      #
#### ##         #### #
####   ###### ######F#
######################