######################
#E   K ########### ###
####     W  ###      #
#### ######     #### #
####     #### ######F#
######################