###########################
#E   K############## ######
### ###########          ##
##        ####   ###   ####
## ##           #####   # #
#####################    F#
###########################